...RR.......
...RR..T....
.s.RR.....T.
...RR.......
...RR..p....
...RRRRRRRR.
...RRRRRRRR.
....S....RR.
.t.......RR.
